8 10
########
#AVav  #
#    #H#
#   -yH#
#    #H#
#   DPH#
#Y DDD##
##Y ####
# y y  #
########
