11 8
###AV######
##  bR    #
#   Rb    #
#    ####H#
###B     H#
####  ###H#
#   B avP #
###########
