9 7
#########
#    G-P#
#   CDCD#
#  MDMDD#
# BDDBDD#
#GDDDDDD#
#########
