10 7
#A####O###
#DDDD LDD#
#DDDDLDrD#
#DDDDDDPD#
#aDDD-orD#
##DDDD####
##########
