8 16
########
#AVO#  #
#   #  #
# r #  #
#r#r#P1#
########
#  o   #
#2    1#
########
#   a  #
#2    3#
########
########
#   v  #
#-    3#
########
